▤▤▤▤▤▤▤▤▤▤▤▤▤▤▤▤▤▤▤▤▤▤▤▤▤▤▤▤▤▤▤▤▤▤▤▤▤▤▤▤▤▤▤▤▤▤▤▤▤▤▤▤▤▤▤▤▤▤▤▤▤▤▤▤▤▤▤▤▤▤▤▤▤▤▤▤▤▤▤▤
▤♣            ▤▤         ☠   ▤                 ▤   ▤▤     ▤      ▤   ▤   ▤    ▤▤
▤   ▤▤▤▤                     ▤                           ▤▤                    ▤
▤   ▤▤▤▤        🪙                                         ▤                    ▤
▤                            ▤             ♣              ▤           🪙        ▤
▤♣♣♣                         ▤             ♣                         *         ▤
▤♣♣♣♣    ▤  ▤▤▤▤▤▤▤▤▤▤▤▤▤▤        🪙     ♣♣♣♣♣♣     ▤                    ▤
▤ ♣♣♣♣   ▤      ▤            ▤                            ▤           🪙        ▤
▤  ♣     ▤      ▤            ▤                            ▤                    ▤
▤               ▤▤▤▤▤▤▤▤▤▤▤  ▤                🪙           ▤                    ▤
▤   ☺♣   ▤                   ▤▤▤▤▤▤▤▤▤▤▤                  ▤                    ▤
▤        ▤            🪙                      ▤            ▤            🪙      ▤
▤        ▤▤▤▤▤▤▤▤▤▤▤▤▤▤▤▤▤▤▤▤▤    ▤ ♣♣♣♣♣♣            ▤                    ▤
▤                            ▤               ▤              ▤                    ▤
▤                  ♣         ▤               ▤            ▤                    ▤
▤          🪙           🪙    ▤               ▤            ▤                    ▤
▤                                   ▤  ▤                         ▤                    ▤
▤  ▤             *       ▤   ▤                       🪙    ▤              🪙     ▤
▤  ▤                     ▤   ▤                     *      ▤                    ▤
▤  ▤                     ▤   ▤       🪙                    ▤▤▤▤▤▤▤▤▤▤▤▤ ▤▤▤▤▤▤▤ ▤
▤  ▤          🪙         ▤▤▤▤▤                            ▤                    ▤
▤  ▤                         ▤                  🪙        ▤                    ▤
▤  ▤                         ▤                            ▤                    ▤
▤  ▤  ▤▤▤▤▤▤▤▤▤▤▤▤▤▤▤▤▤▤▤▤▤▤▤▤            ♣♣♣♣♣♣          ▤                    ▤
▤  ▤                         ▤             ♣♣♣♣           ▤                    ▤
▤  ▤                         ▤                            ▤                    ▤
▤  ▤     *            🪙      ▤                                   🪙            ▤
▤  ▤                         ▤            🪙               ▤                    ▤
▤                                                        ▤                    ▤
▤▤▤▤▤▤▤▤▤▤▤▤▤▤▤▤▤▤▤▤▤▤▤▤▤▤▤▤▤▤▤▤▤▤▤▤▤▤▤▤▤▤▤▤▤▤▤▤▤▤▤▤▤▤▤▤▤▤▤▤▤▤▤▤▤▤▤▤▤▤▤▤▤▤▤▤▤▤▤▤